oooooooooo
o---e---fo
op-------o
o-p---pp-o
o-p------o
op-f---p-o
o--------o
op-----f-o
o----e---o
oooooooooo