ooooooooooooo
o---e---f---o
op----------o
o-p---pp----o
o-p---------o
op-f---p----o
o-----------o
o---p-------o
o---p-------o
o---e-------o
op-----f--p-o
o----e------o
ooooooooooooo