oooooooooooooooooooooooooooooooooooooooooooooooooooooooooooooooooooooooooooooooooooooooooooooooooooo
o-------------------p--------------p--p-----p----------------p---------------p----p-p-p------------o
o---------------------------p---------------------------------------------p------------------p-----o
o----p-----------------------p---------------------------------------------------------------------o
o-------p------------------f---------------------------p----p------------p--------------p-p---p--p-o
o-p--------p-----p---------pp--p----------p---------p----------------------------------------------o
o----------------------------------------------------------------------------------p-----p---------o
o---p-------p--p----p-------------p----------------------------------------------------------------o
o-----------------------------------------------------------------------p--------------------------o
o---------------------------------------------------------p-----p---------p---------p--------------o
o--------------p-------------------p-------------p---------p-p-p----------------------p------------o
o---------------------------------p---------------------------------------------p-------p----------o
o-------------------------------------------------------------------------p----------p-------------o
o-----------------p-----------------------p------p-----------------------------------------p--p---po
o----p------------------------------------------------------------------------------p--------------o
o---------------------------------------------------------p--------------------------------p-------o
o-ppp--------------------p-------------p---p--------------pp-----------p----------------p-----p----o
o-----------------------p----------------------p-------------------------p--------p-----f---------po
o---------------------p--------p-------------p-------------p--------------------------p----p-------o
o-----------p----p---p---------p--p-----------------------------------------p----------------------o
o---------------------------------------p-p-------------------------p-----p------------------------o
o-----------------------pp------------p-------------p----------------------------------------------o
o---------------------p---------------p---p-------p-----------------------------------------------po
o--------------------------------------p------------------------------------------------p--p-------o
o-----------p------------p-----------------------p------------------------------------------------po
o---------------p------------------------------p--------------------------------------------p-----po
o-----------------------p--------------p----p----------------------------------------pp------------o
o-------------------p-------------------------------------------------p----------------------p-----o
o----------------------p----------------------p-----e--------------------p------------------------po
o---------------------------------p----------------p----p------------------------------f----p------o
o----------------------------p------p---p-----------------------p--p------------p------------------o
o-------------------p----------p---------------------------------------------p----------p--p-------o
o-----p------------f--------------------------------------p-----------p----------------------------o
o------------p--------------------------p----pp-p--p-p-------p---------------------p--p------------o
o------------------p-----------------p--p--------------------------------p---------p----------p----o
o-p-----------------------------------------------------------------------------------p-----p------o
o------------------p---------------------p------p-----------------------------------p--------------o
o----------------------p-------------------p---------p--------------------------------p------------o
o--------------------------------------p-----------------p-------------------p-------p-------------o
o-------p-----------------p--------------------------p--------p------------p---p-------------------o
o--p---------------------------------------p----------f--------------p-p--------p------------------o
o-------e-----p-p-pp--------------------------------p---------------------------------pp--p---p---po
o-------------p------------------p--------p---------p---------------------------------p-------p----o
o-------------pp----------p---------p-----pp-p-----p------------p-------------------p--------------o
o---------p--p------------------------------------------------------------------------------------po
o-----------p---------------p--------------------------------------p---------------------------p---o
o-------p--------pp-------------------------e---------p--------------------------------------------o
o--p-------------------e----------------p-----------p----p-----------------------------------------o
o-------------------p-----------p----p--------------p------p---------------------------------------o
o--------------------------------p--------------------p-p-------p-------e--------p-----------------o
o-------------------------------------p-------p-----------------------------p----p-p------p--------o
o--------p------p---------p----p------------------------------------p-----p---------p--------------o
o--------------------------------------------p-------------------------------------p---------------o
o-p------------------p-----p-----------------------------p-f-----------p----------------------p----o
o--p---------p-------------------------p-----------------p----p----------------------------p-----p-o
o--------p-----p---p----------p-------------------p----------------------------------------p-------o
o----------------------------------------------------------------------p---------------------------o
o-----------------------p--------------------p-----------------------------------------------------o
o-------------p----------p------p--p---------------p------------p----------------------------------o
o----------------------p---p----p------------------------------------------------------------------o
o---------------------------p-p--------------------p---------------p-----------------p-------------o
o----------------------------------------------f----------p--------p-----------------p-------------o
o-----------p---------p--p--------------------------------p-----------p---------------------------eo
o-----------p----------------------------------------------p-p-----------------------p----pp-------o
o--------------------------p-------p--------------p----------------------------p--------------p----o
o-------------------------------------------p------------------------------------------------------o
o----------------------------------------------p-------------p-pp------p-----p--f------------------o
o---------------pp--------------------------------------------p-----p------------------------------o
o-------------------------------------------------p----------p-------------p-----------------------o
o-p-----------------------p-----------------------p----------p----------p------p-----p-----p-------o
o----------p-p-------------------------p---------p----------------------------p------p-------------o
o---------------p-------------------------p-----------------p-------p---p--------------------------o
o----------------------------------------------------------------------------------------p---------o
o-p--------p------------------------------------------------------------p-------p------------------o
o---------------------------------------------------------------------------------------p----------o
o----------------------------pp-----p-----------p-------p--------p--------p--------------p---------o
o------p------------------------------p--------------------------------------------p-------------p-o
o------p--------------------p---------------p------------------------------p-----------------p-p---o
o---------------------------------pp----------------------p--p---------p-----------------------p---o
o--------------------p------------------p---------------------p--p--p--pp--------------------------o
o------------p------pp---------------p---------------------------------------------------p---------o
o----p--------p---------pp---p--------p-------------p---------p------------------p-----p-----------o
o--------pp----------p----------------p-------------pp---------------------p------p--------p-------o
o-p---------------------p-----p------p-------------------------------------------------------------o
o--------------------p------------------------p-------------p---------------------------------p----o
o------------pp------------------------------p---------------------p---------------p-----p-----p---o
o-------------------p---------------------p--------p-------------------------pp----p---------------o
o-------------------------------------------------------------p------------------------------------o
o--------------p----------------------p------------p-----------------------------------------------o
o------------------------------------------------p-----------------------p-----------p-------------o
o--p-----p-------------------------------p-------p--p-----p--p-------------------------------------o
o-----------------p----------------------------------------------p--------------p----p-------------o
o----p------p---------------------p-----------------p---------------------p------p-------f---------o
o---------------------------------p---------------------------------------------p----------------p-o
o-----p--------p--------------------------------p-----------------p--------p-------p---------------o
o-----------------p----------p------p------------------f-------------p-----------------------------o
o---------------------p-p---------------------------------------------p----------------------------o
o-p-------------------------p------------p---p-------------p--------p--------p---p----p------------o
o----------------------------------------p----------------------------------p----------------p-----o
oooooooooooooooooooooooooooooooooooooooooooooooooooooooooooooooooooooooooooooooooooooooooooooooooooo