---r---l---
r----------
-r---ll----
-r---------
r-r---l----
-----------
---r-------
---l-------
---l-------
l-----l--l-
----l------
----------l