--------------------------------------l---------l-
--------------------------------------------------
--l------------l-----------------l---------l----r-
--------------------l-l---r--------------l---l----
------------------r-l-----------------------------
--------------------l-----------------------------
---------l--l------l-----ll----------------l------
----------------------------------------------l---
------------l----------------------r--------l--l--
----------l------------l-----l------------l-------
--l----l--r-l-l---l---r----------------------r----
----l---------r-------l-----l---------------------
-------------l------------------------l-l---------
-----------------r------l-------------------------
--------r--------l---------------------------r----
-----------------------l----l---------------------
-----r-------------------l---------l---l-l-----l--
--l-----l-------------ll-l-l---------------------l
-----l--------r----r---------------l-------l------
-----r------ll---l--------------------------------
------------------------l-------------l-------l---
----------------l---------------ll----------------
----r-l-----r------------------------------r-----l
----------l---l-----------------------------------
------------------------------------------l--l-l--
------l-------------------------l-l---------------
------------------r-------------------------------
--------------------------------------------------
----lll-------------------------------------------
---------------------------l-----------l----------
---------l------------------------l---------------
---r----------r---------------l-------l-----------
-----------------------------------------l----l--l
-----------ll------r----------------------l-------
----l---------------------------------------------
-----------------------l--------------------------
-----lr---------l--l------------------------------
--------l-------------------l---r-----------------
------------------------------r-------------------
------------------------------------l----l--------
-------l----l---------------------------------l---
------l-------------------r-----------------l-----
--ll----------l-----l----------------------ll-----
---------------------------------l----------------
---------l-------------------------------l-ll-----
-------l--------------------l----------------r----
-l----------l--l---r---l--------------------------
----------l----------l---------r------------l----l
---rl----l-r-------------------------------------l
-l----l-----l------------------l-----ll-----------