---r---l----
r-----------
-r---ll-----
-r----------
r-r--rl-----
------------
---r--------
---l--------
---l--------
l-----l--l--
----l-------
----------l-