-------------rl------------------------------------------l------l-------------------l-------------l-
------------------l--------------------r-----------------l--------------------------l-r---l-----l---
----l----------l-------------------l-----------l---------l---------------------l----l---------------
--------l--l------------l---l-----------------ll---------l-----l--ll---r----------------------l-l---
----l----l----------------l----------ll----------l-l--------------------------ll--------------------
-------------------------------------------------------------------l--l-----------------l---------l-
--------r----------------------l---------------l---------------------l-------------r--l--l---------l
-----------------------r----------------------l-----l--------------------------------------l--------
-----------------l-------------l-l---------r----------l--------------------------------l-----l------
------------------l--------------------l----------------------r-------------------------------------
----l-----------r---------r------l--------------l-----l----l-----------r---------l------------------
----------l-------------r------------------ll-------------------------------------------------------
--------------------------l--------------------l--------l-----------------ll-----l------------------
---------r---l-------------------------l----------------------------------------------l-------------
----------------l----r-l-l----------l--------------r------------------------------------------------
--------------------------------l------l----------------r---------------------l---------------------
------------------------------rl----l-------l-------l-l-------l-------------l----r--l--------------l
---------l-------------l--------------l-----------------------l------------------l-------l---lr-----
---------------l------l----l---------------------------------------------l--------------l-----------
-l----------------------l-----------l--l----------------------l---------------------------------l---
-r---------l-l---------r------------------l---r------------------------l-----rl---------------l-l---
------------------------------------l-------------------l------l-------------------------l-------l--
r-------------l----------------------l------------------------------------l-r------l------l--l------
------l-----l----------------l-----l------------------l---------------------------l-----------------
--------------------------------l-------------------------------------------------------------------
-----------------l----------------------------------------l----------l------r--------------------l--
-------------------------------------------------------------------------------------------l--------
--l--------------------------------l-----------------------------r------------------------l---------
-l-------------l----------------------------------------r-------------------------l-----------------
-r----------------------l-------------l-------------------------------------------------------------
-------------------------l--l------l-----------l----------l----------------------l------------------
-------------------------l-------------l--l-----------------------------r------------l--------------
-l------------------------l------------------r--------------l---l-------l----------l----------------
-------------------------l------------------------------l-----l-l---------------------------------l-
-l------------------r-------r------------l-l------------------l---------------l-----------l---------
--r------------------------------------------------------------------ll-----------------------------
-------------l-------------------------------l---------r---l----------------------------------------
------l--------------l-l---------lr----------------------------------------l------------------------
-l------------------l-------------l------------l-----------------------------r----------------------
------------l---------l----l-------------------------------------r----------------------------------
--------------------l-l------------l--------------l----------l-----------------------------------l--
-----l--------l----------------------l------------------l--------------------------------------l----
--------------------------------------l-----------rl------l-------------------------l-------l-------
---------l-lr-----------l--------------------l-----------------------------l-l-------l----l---------
------------------------------------------------l-l------l--l------------------------------l--------
-----------l-l------l--------l--l------r--l--l-l-r---l-----------------------------------------r----
--------------l----r-r---------------------------l----------------------------------lr--------------
----------------------r---l----------l--------------------------------------l-l--l------------------
-----------------------------------------l---------------------------r----------l-------------------
---l-l---------------l------------------------------------l------------------------l----l-----------
---------------------------------------r---r------------------------r--------------------l----------
-------------------l----l------l----------------------------------------l---------------------------
----------l---------------------------------------r-------ll----ll--l-----------------------l---r---
------------------------------------------l--l-----r--------------------l---l----------ll-----------
-----l----------r---------------------------------l-----------------------l-------------------------
--------------------------------------------------l---------------------------------------------l---
--------l--------------------------------------ll-----------------r---------l------------l----------
----------------------------------------------------------------------------------------------------
-----------l------------r-ll---------r------------------l-------------------------------------------
-----------------------------------l---l--------------------l-l----------l--------l-----l--ll-ll----
----------l-------r-------------------l--------l----------------r-l------r--------------------------
--l------------r--l---------l-----------------------------------------------l----------------------l
---l----------l-----l---------------l-------l-----------l-----------------l---------l-l--l----------
------l----------------l----l-----l------------------------l--l-l-------------------------------l---
----------------------------------------l-----------------l-----------------------------------------
-----------------------------l------------------l-----l-------------------------------l-------------
------------------l-l-------------------r-----------l------------------r---------------r------------
----r---------l--l---l-----------------------r-ll--ll-----------------------------------------------
----l-------------------------------r--------------l-----l---------------l--------------------------
----r------------r-------l------------------------------------------l--r-----------l----------------
r----l-l------------------l---------l---l--------l-----------------------lr--------l-l--------------
--------l------l------------------l-----------------------------------------------------------------
-l--------l----------------------------------------------------ll---------------------l-------------
l-----------------------------------------------------------------l-----------------l---------------
-------------l------lll--rl------l--------r-------------l--------lr--------------------------l------
----------l------------l--------r-----l--------------------l------r------------------------------l--
-------l------------l---------------------l--------------------------l--------l-------------------l-
-rl-----------l------------l-----------r---l-------------l-----------------------------------------l
------------------------------l---------------------------------------l-----------------------------
------------------------l-----------l-------------------------------l------------------l-----l------
---------------------l---------l---------------------l---------l---------------r-----------------l--
l------------l--------------l---------------------------------------r----l-----------------l--------
--l-------r----------l-l-------------------------l---------------------------------------------l----
----------------------------------------------------------------------------------------l-----------
-----------------l-l----r-----------l-------------------------l--------r--------------l-----l-------
---------l--------l-l----------------------------l------------------------------------------------l-
---------l----------------------------ll-------l--------------------------------------------------l-
---------------l---------------l---------l---l-------------------------l---ll----l--------ll--------
---------------------------------l------l------l----------------------l-----ll-----l----------------
-l------l--------l-------r---------------------------l-------l-------------------------------------r
-----------------------------l-------------l-----------l----l--------r--------l---------------------
---l-----------------------------------r--------------------l---------------l-----------------------
---------l--------------l---------------------l-----------l----------------l---r------l-------l----l
--------l---------------------l--l-------------r----l--------------------------r--------------------
l-------l----l------------------------------------r--------l-l-----l--------------l-----------------
--l----l-----------r----------------------------l--------------------------l----------r-------------
-----------------------------l-------------------l----------------------r----------------l----------
----------------r-------------l-----------------------------------l---------------------------------
------------l-------------l-----------r----------------l----------r-----r------------r--------------
-------------------l------------l-l-------------------------ll---------r----------l----l----l-------