-------l---
-----r-----
-r---llr---
-----------
------l--r-
----r------
-----------
---l----r--
----l------
l-----l--l-
-r--l------
--------r-l