---r---l---
r----rr--r-
-r---llr---
-r--r------
r-r---l--r-
--r-r-----r
---r--r----
---l----r--
--rrl---r--
l-----l--l-
-r--l-r----
--r-----r-l