----------------------l------------------------------------------------l----------------l------------------------ll-----l-----l-----------------------
-------------l-----------------------------------r--------l-----------l-----l---------------------------l------l-----l-----------------------l--------
-----l----------------l--------------------------------------------l-----l--r-------------l-------l----------------l------l-----l------------l--------
-------l---l-------r--------r--------l-----------------r----------r-----------l-----------------------------------------------------------------------
l-----------------------r---------------------------------------------l--------------------------l---------r-l----l---l-------------------------------
----l--l--l-------------------------r----------------------------------------------l-l-------l-------------------ll------------l----------r-----------
--l-----l-------------------------l-------------------------------------------------------l-----l-------l----r-----------l----l-----------------------
-----l-------------l---------------l----------------------l---l-----------l---r--------------l-------------------lr-------------------------------l---
----l------r-----------------l----l------------l--------l---r--------------------------------------l---------------------------ll---------------------
----------l-l-----------------------r----------------------------------l------------------------r---------------------r-----l----------l--------------
------------------l-l-r----l--l------------------l--------------l---l------------------------------l----------l-----------l---------------------------
--------------------l----------l-l----------------------------------------------------------------------------------------------------l------l----l---
--------------------l----------------l------------l-l---------------l------l--------------------l----------------l----------------l-------------------
--------------------------------------------------------------l-----------------------------l--------r----------l--l-------------l---------l----------
-----------------l------------------l-----------------------------------------------------------l--l-------------ll--l------------------l--------l----
---------------l-----------------------l--------------------------------l------------------------ll-------------------------------------l--l----------
----------l----------------------------r-------------------------l--------------------------------------------------l-----------------------l---------
--------------------------l-----l-------------------------l--------l----------------l----------l-------------------l---l---l--l-------------------l---
----------------------l---------l---------------------r---------------r----------l----l----l-------------------l----------------------------------l---
-----------------l------r---------------------------------l--------------------------------------------------------------------------------------r----
l------------l--------ll-------------------------------------------------r--------l---------------------------l---------------------------------------
---------------------------------------------l--------------------l---------------------------l----r----------------l--------------------l------------
------------------------l--------------l---------------------------------------------------------------------------l-l------------------l------------r
----l------------l---r----------------ll----------------------------------------------------l--------l---l-----------l-------------------------------l
----------------l---------r------------------------------------------------------------l-ll--------------------------------------------l--------------
-----------------------------------l-----l----------l-----------------------------r---------------------r------l-----------------------------l--------
-r-------l---------------------------l-------------------l---------l-l-----------l-------l----------l-----l--------------------l-------l-----l--l-----
-----l--------l--------l-------ll----l--------l--r---------------------------------------------------------------------r------l-----------------------
--l----r--l-------------------------------------------------------------l----------------l----------------l---------------------------r---------------
--------------------------------------l-----------l-----r--------------------l----l--l--------------------r----r---l-------------r--------------------
------------------l----------------------------------------------------l------l----l------l-----ll----------------------------------------------------
-----------l---------------------l-----------l--------------------------------l------------l-------------------------l----------l---------------------
--r--------r-------------------------------------------l-l----------l----------------------l----l----------l----------------------------------l-------
--l---r-------------------------r-----------l-l-l-----------------l-l--------l-----------l--------------l----------------l----------------------------
----------l--l--------------------l---------------------------------------------------------------------------------------------------------l---------
-----------------------------l----------l----l-----l------------------l--ll----------------r-----------------------r----------r-----------------------
--------------------l-----------------------------l---------------------l-------l------l----------------------l---l-----------------------------------
--l------l-----l----------l---------------l--l--l-----l--------------------r-----------------------l--------------------------------------------------
---------------------------l-------------------------------------------l--l----l---------------l------l-----r---------r-----------l-----r--l----------
----l--l----------------l-------------------l---l------------------------------------------r-------------------------------l--------------------------
---------l--------------------l-----l----------------------------l--------------------r-------------------------------------------l-------------------
-------------l----l-l------------------------------------------------------------------------------l----l-----------------l-----------l------ll--l----
----l-------------------------r----------------------------------------------------------------------l---------------------------r----l---------------
----ll-----------l--------r----------l--------------------l------r----------l---l----------------------------------l-------l--------------------------
-----------------------------------------------l------------------ll----------------------r----l---------l-------l--l--------------l--------------l---
---------l----ll-------l--------------------------l--------------------------l--l---------------------l------------------------l---rr----lr--------ll-
-----r--------l--------l-----------l-l-----l------------------------l---l--------------l---------------r-----------------------------------------l----
----------l------------------l------l--------------------------------------------------------------------l--------------------l-----------------------
------r---ll----------l---------------------------l-------------------l---ll-----------------------l-l-----l-------l----------l---ll--------l---------
------------l---l-------l------ll--------l-----------------l----l------l---------l---------------------------l--l-----------------------l-----l-------
------------------------------l----l---------l----l--------l------------l----------------------------------------l---------l-------------------------l
---l------------------------l------------l-----------------------------------l-----------------------------------------------l-l----------------------
-l-------l----l------------------------l--l--r--l------------------l------------l-----------------------------------l--l----------------l-------------
l----------l------ll------------------r-----l-----l------------l-------------l---------------------------------------------------l--l---l---l---------
-------------------r---------l-l--------r--------------ll----------------------l--------------------------l---------------------------l-------------r-
----------------------------------l-----l---l------r---rl--------l-------------------l--------l-l-----------------------------------------------------
--------------------------------------------------------l---------r------------------------------l--l-l-----------------------------------------------
-------------------------------------------------l-------------r-------------------------l---------------------------------------l--------------------
--------------l----------------------------------------------------r--r--------------------------------------------l---------------l------------------
----l----------------------------l----l----l-l-----------------------------------------------------------l--------------------l-----------------------
-r-----l-------l-----------l------l---------l--l-----------------r-------l--------------l-------------l---l-l----------l------------------------------
--r--------------------------------l----r-l----------------------------------------------l----------------------------l--------l----------l-----------
---------------------------------------lr---------r--------------------r--------------------l-------------l------------l------l---------------------ll
-------------------l-----l----l-------------l-----------------------------------l----------------l-----------l----------------------------------------
---------------------------l------l-------------------------l---------------------------------------------------------------------------------l--l----
------------------------------------------------------------l--------------------------------------------------------ll-------------l-----l-----------
-----l--l-l---------------------------l--------------------r------------l-------------l-------------------------------------------------r-------------
---------r--------------------l---l--------l-----------r----------l---l---------------------------r----------------------------l--l---------------l---
--------------------------------l-------l-------l--l---------------l-----------l---------------------------------------l------------------------------
-------------------------------------------------r------------------l----------------------------l-----------------------------------l------l---------
-------r------r----------------------------------r------------l--------------------------------------------l---l--------------------l------------l----
------l-----l--------------l----------l----------------------r------------------------------l--------------------------lr----l--------------l---------
----l-------ll-----l-------l--l------l-----l-------l--------l--------lr-------l-------------------l---l-----------------------------------------------
--------------------------------l--------------l-------------------------r-------l----r------r-------l--------------------------l---------l-----l-----
----l---l----------------------l-------------------l---r---l--------l-----l--------------r----r--------------l------------------r-------r--lll-----l--
------------------------------------ll----l--------l-----r-----------------l------------l---l------l-----------l----l----l------r----------l----------
l---------l---------l-----------------------l------------------------------l------------l--------------------------l----------------------------------
--------------------------------------------l--------r-l----------------------r-------------------------------l------r---------l-------l------------l-
-----l------------------l---------------------------------------l-----------------------------------------l--------------------l---------r------l-----
----l----------------------------l------------------l-----------r-------------l--r-----------------------l--------------------------------------------
l-----l-------------l-------------------l---------l--------------------------------r-r--------------------------------------l---------------l---------
------------------------------------------------------l---------------l--------------------------------l---------l--------------------------------r---
-------------------------l-------------------l-----------------l---rl--------------l-------r---------------------l---l------rl------------------------
------------l--l----------------------l-------------------ll-----------------------------------------------l---------------------------l-----------l--
------------------------l--l------------------------l---------------------l-------------------l---------ll--------------------l-----------------------
-------------------ll--------------------------------------------------------------------------------------l-----r-------l--r-------------------------
------------------------------------l----------------------l---------------------l-------l-----------l------------------------l-----l-------l---------
-----------------l--------------------------------------------------------------------------l------------------------l--------------l-----------------
--ll-llr-------------l----------l------r-------------r--l---------------ll--l-------------------------------------------------------------------------
--l-----------l---------------ll---l-----l-----------------------------------------------l------------------------------------------------------------
---ll--------l------------------r------l--l----l-----l--------------------------------r---------------l--------------------------l---l----------------
--l---------l--------------------ll--------l----------------------------------------------------r---------r-----------l-------------------------------
---------l----------------------------l------l----------l--l----------------------------------------l-------------------------------------l-----------
--l----------------r----------------------------l-----r-------------------------------r---------r-----------------------------l-----l--l----l-l-------
---------------l-------------------------l-----------------------l------------------------------l----------------------l--------l---------------------
--l------------l----------------------------l-----------l---l------------------------l-----l--r-----------------l--l---l----------------------l-------
--------r----------------------------------------------l-l--l------------------------------------l---l-l----l----------------------l----l-------------
---r--------------l--------l------l-------r---l--l--------------------l-----------l-------------l--------l--------l-l--l-----------------------lrr----
----------l-l-------------------------------------------------l-----l---------------r---l--l----------l-------------------------------r---------------
---------l--l----l-----------------l------l------------------------------r-------l---------l------------r-----------l---------------------------------
----l-----------------------l------------l-------------------------------------------l--------l------------------l----l--r----------------------------
--------------r--------------l-l-----l--------------------------------------l----------------------------------------------------l-----l-----r------l-
--l----------l----------l--------------l-----------------l---------------------------------l----------r---l-------------------------------------------
---------l----------------rr-l-------------------------lr-l-------------------l-------------l---------------l---------r-----------------------l-------
-------------l-----------------r-----------------l----------------------------------l---------l------------------------------l---------l---------l----
----------l-------l-------l----l-----------l----l--l----l----------l--------------------------------l-l---l--------lr---------l---------r---l-l-------
l--------------------------l---------------------------------------r--------------l---r---l---------l--------l--l------------------l------------l-----
-------------l-------------l---l-------------------------------------l-------------l-------r---------------------r---l-----------------------l--------
--l------l----------l--l--------------------------l----l--r-------------------------------------l--ll--------l--------------------------------r--l----
----l----------------------l-------------l---l--------------------r----------------l-------r-l-------------------------------------l-----l------------
------------------------------------------------l-l-l-----l--------------------------------------------------------------------------------------l---l
-l----------------l------------------------------------l--l-----l---r--------------------l-----l------------------------------r--------l--------------
r--------------------------l---------------------------------rl------l----------------------------------------------l--l------------------------------
------------------------------------l--------l------------------------------l--------------------------l----l--------------------------------l------l-
--l---l--l------------------------------------------l-----r---l-------------------------r------------------------l-----------l---l--------------------
-----------l---------------------------r-------l----l-------------l-----------------------------------------------------------------------------------
-------------l-----l--------------l--------------------l---r---------l---l---------------------------------------------------------l-----------------l
-----l---------------------------------ll------------------l---ll------------------------------------------------l----------------l--------------l----
--------------------------------l-----------l----------------l----------------------------r----l-------l---l----------l----l--------------l----------l
---------------------------l---------------------ll----------------r-l---------------------------------l----------------------------------------------
------------------------------l--------l---l--l-------------------------------------l----------------------------------------l--------l---------------
-----------------------------------------------------------------------------------l-l------r-l-----------------------------------l-----------------r-
-----------l-------------------------------------l------r--------l------------------------l------------------l--------------------l-----l-----------l-
---r-----------------------------------------------------------------------------------------r------r--------------------l----------------------------
---------------------l-------------------------------------------------------------------------l-----l-------------------l----------------------------
--------------------r--------r-------------------------------------------------------------------l------------------------------r---------------------
---l----------------------------------------------l---------l---------ll---------------------------------------------------------l-----l--------------
----------------l---l-----------l---------------------------r------------------------------------------l----l---------------------l------------l------
--------------------------l-------------------------------------------------------------------l-----------------l----l-------l------------------------
------------------ll---------------------l---------rl-------r-----------------------------------------l---------l----------------l-----l--------------
--l------------------l---------------------------------------------------------------------------------------r----------------------------------------
------------------------------------------l-------------------l-l-r--l------l------------l---------------------------l---------------l--l-------------
-----l----------r------------------l-----l----------------ll-l-l-----ll------------l-----------------------------l-------------------r----------l-----
-----------------------------------------------------------------------r--ll---------l----l---------------l--------r----------l----------l------------
-------r---------------l-------------------------------------------------------------------------l---------------l-----------------------l--l-----l---
---l---------------l----------------------------------r---l--------------------l-l-------------------------------l-----------------l--l---------------
-------------------l---------------------------------l---------------------------------------------------------l------------r-------------------------
--l-----------l-l--------------------------------l-----------l------r---l------l-----------------l------------l-----------------------r-------------l-
---l-------------l----------------------------------------------l-------------ll-------l------------------------------------------------l-------------
------------------------------------------------l---------l-------------------l---------------------------l-r--------l------r--------l-----------l----
------------------r-------------------l----------------------l----------------------r----r----------------------------------------------------------r-
-l----------------------------l--------------------------l-l----------r--------------------r------------------l---l--------------l-------ll-----------
----l--------------l----------------------------------------l----r---l------------------l---------------------------------r------l-----------------l--
-------------------------------------------------r------l----l----l----r------------------------------l-------------------------l------------l--------
----------------------------------l-------------------------------------------------------------------l---------------------l--------l-r--------------
-----l-------l-------------l----------------l-----------------------------------------l--l---------l---------r----------------------------------l-----
-----------l-----ll---------------------------l-----------------l----l----------------l---------l-l---------------------------------lr----------------
-----l--------l-r--------l-----l--r---------------l------l-------------------l-----------------------------l-------l----------------------------------
------------------------------------ll----l--------------l------------l----------l--------l--l-----------------------------ll-------------------------
-----------------------------------l-----------------------------------l---ll-------------l---------l---l-------------------------l-------------------