-------------rl------------------------------------------l------l-------------------l-------------l-
------------------l--------------------r-----------------l--------------------------l-r---l-----l---
----l----------l-------------------l-----------l---------l---------------------l----l---------------
--------l--l------------l---l-----------------ll---------l-----l--ll---r----------------------l-l---
----l----l----------------l----------ll----------l-l--------------------------ll--------------------
-------------------------------------------------------------------l--l-----------------l---------l-
--------r----------------------l---------------l---------------------l-------------r--l--l---------l
-----------------------r----------------------l-----l--------------------------------------l--------
-----------------l-------------l-l---------r----------l--------------------------------l-----l------
------------------l--------------------l----------------------r-------------------------------------
----l-----------r---------r------l--------------l-----l----l-----------r---------l------------------
----------l-------------r------------------ll-------------------------------------------------------
--------------------------l--------------------l--------l-----------------ll-----l------------------
---------r---l-------------------------l----------------------------------------------l-------------
----------------l----r-l-l----------l--------------r------------------------------------------------
--------------------------------l------l----------------r---------------------l---------------------
------------------------------rl----l-------l-------l-l-------l-------------l----r--l--------------l
---------l-------------l--------------l-----------------------l------------------l-------l---lr-----
---------------l------l----l---------------------------------------------l--------------l-----------
-l----------------------l-----------l--l----------------------l---------------------------------l---